a_	ah!
abit	loĝi
adres	adreso
adulte	plenkreskulo
afrika	Afriko
agres	agresi
aha	ekkompreni
ai	ve!
aka	frato aŭ fratino
akse	akso
alah	Alaho
alkol	alkoholo
almari	ŝranko
alter	alia
alu	terpomo
ama	sed
amerika	Ameriko
amor	ami
amper	ampero
analis	analizi
andjil	evangelio
anime	animacio (movbildo)
anten	anteno
arabi	araba
aranji	oranĝo
arena	stadiono
armi	armeo
arte	arto
arxentina	Argentinio
asal	origino
asan	pozo
asia	Azio
asket	asketo
asma	astmo
aspirin	aspirino
ata	faruno
atak	ataki
atom	atomo
audi	aŭdi (aŭskulti)
australia	Aŭstralio
aventur	aventuro
ax	ve!
baca	lingvo
baca logi	lingvoscienco
bad	malbona
bada	post
badal	interŝanĝi
badam	migdalo
badan	korpo
bagaj	bagaĝo
bai	blanka
bal	forto
balkon	balkono
balu	sablo
bambu	bambuo
ban	ido (filo aū filino)
bana	konstrui
banan	banano
banda	bendo (fasko)
bandera	flago
bandi	malliberulo
bandi kan	malliberejo
bangla	Bangladeŝo
banko	benko
banya	bano
banya kamar	banejo
barat	Barato (Hindio)
barbar	barbaro
barda	barbo
barka	gratuli
baru	urso
bas	sufiĉa
basen	baseno (cisterno)
basket	korbo
bat	ok
batata	batato
bateri	baterio
batu	ŝtono
bauhu	protekti
bazar	bazaro
baze	bazo
bebe	bebo
bed	lito
belgi	Belgio
beng	malsana
benzin	benzino
beranda	verando
beret	bereto
beria	lupo
bet	domo
beton	betono
bi	je (per, kun, de)
bi no	sen
bi tema de	pri
bi yang de	kiel
biblia	Biblio
bir	biero
bis	kisi
biskut	biskvito
bite lai	inviti
bite lai in!	Eniru!
bizar	stranga
bizi	okupita
biznes	komerco
blu	blua
bobo	stultulo
boi	knabo
boikot	bojkoto
boka	buŝo
bola	pilko
bolgaria	Bulgario
bolivia	Bolivio
bomba	bombo
bon	bona
bot	boato (ŝipo)
botol	botelo
boton	butono
brazil	Brazilio
britan	Britanio
broc	broso
brun	bruna
buda	Budho
buda din	budhismo
budan	Merkurio
budjet	buĝeto
buk	libro
bul	forgesi
bumi	tero
bunduk	pafilo
bus	buso
cabi	ŝlosilo
cak	dubi (suspekti)
cam	vespero
camba	kampo
can	monto
cani	Saturno
cans	oportuno
canti	paco
carbon	karbono
catan	diablo
cau	malmulte
ce	afero (aĵo)
cef	estro (ĉefo)
cia	subo
cigo	akcidento
cim	koro
cin	kredi (fidi)
cir	poemo
corab	ŝtrumpo
culi	ripari
dai	granda
danke	danko
dans	danci
dant	dento
dap	respondi
dar	doni
darba	frapo (bato)
daria	maro
darsa	lerni (studi, leciono)
dau	vojo
dawa	medicino (medikamento)
dawa kan	apoteko
de	de
debat	debati
deci	deci-
dem	punkto (preciza loko)
demo krati	demokratio
demon	demono
den	tago
deng	atendi
desen	desegni
detal	detalo
deya	vilaĝo
dian	atenti
din	religio
diske	disko
djang	batalo
djangal	arbaro
djara	kruĉo
djeb	poŝo
djen	nasko
djidju	araneo
djin	ĉe
djungok	Ĉinio
do	al (ĝis)
doitc	Germanio
dok	legi
dolar	dolaro
dom	hejmo
domino	domeno
dong	oriento
dou	fabo aŭ pizo
doze	porcio (dozo)
drama	dramo
du	du (2)
dua	preĝi
duc	duŝo
duka	malĝojo
dum	vosto
duman	fumo
duna	duno
dunia	mondo
dunia baca	monda lingvo
dur	daŭri
e_	esti
ekran	ekrano
ekuador	Ekvadorio
eletre	elektro
eletron	elektrono
energi	energio
englic	angla
eris	Eriso
eritra	Eritreo
espanya	Hispanio
esti	Estonio
eurasia	Eŭrazio
euro	eŭro
europa	Eŭropo
europa uni	Eŭropa Unio
fai	fajro
faida	utileco
fain	fajna
famil	familio
fan	kontraŭa (mala)
fanat	fanatiko
fantom	fantomo
far	malproksima
feber	febro
fei	flugi
fem	ino (virino)
fer	fero
festa	festo
fiksa	fiksi
filme	filmo
filsofi	filozofio
fin	fino
finger	fingro
finger wen	ringo
fizik logi	fiziko
fobi	timi
fokus	koncentri (fokuso)
forka	forko
forma	formo
foto	foto
frans	Francio
fu	fi!
fuk	vesti
ful	plena
fung	vento
funsi	funkcii
futur	estonta
gadja	elefanto
galeri	galerio
gami	edzeco
gana	kanti
gang	ĵus
gar	ĉaro (aŭto)
garam	varma
gardin	ĝardeno
gas	gaso
gatci	valoro
gau	alta
gazet	revuo
gen	radiko
gida	gvidi
giga	miliardo
gim	oro
ging	respekto
glas	vitro
go	iri
gok	lando
gol	celo (golo)
gon	antaŭa
gong	laboro
gong jen	laboristo
gong kan	laborejo
goro	porko
goton	kotono
gras	graso
grimas	grimaco
grup	grupo
guanci	rilato
guang	lumo
gubu	hipopotamo
gun	eco
guru	guruo (instruisto)
gusta	gusto
ha	havi
haha	ridi
hai	ankoraŭ
hak	rajto
hakim	juĝi (verdikto)
halo	saluto
hamar	martelo
hat	mano
hata	eĉ
hawa	aero
hazar	ŝanco (hazardo)
helen	greko
hen	tre
hewan	besto (animalo)
hima	neĝo
hisab	kalkulo
histori	historio
hoki	hokeo
hor	horo
hotel	hotelo
hua	floro
i_	kaj
idea	ideo
igen	opinii
iha	azeno
imper	imperio
imper xan	imperiestro
in	interno
incala	esperi
ingai	devus
inter	inter
interes	interesa
intervu	intervjuo
irak	Irakio
iran	Iranio
islam	islamo
italia	Italio
itiopia	Etiopio
izi	facila
ja	jam (esti -ita)
jadi	se
janela	fenestro
janu	genuo
jelos	ĵaluza
jen	ulo (persono)
jentil	ĝentila
jeste	gesto (mieno)
jiraf	ĝirafo
jiva	vivi
jiva logi	biologio
joga	ludi (sin amuzi)
jok	ŝerco
jovan	juna
jumla	frazo
jup	jupo
jus	suko
ka	kiel (ol)
kabil	kapabla, ebla
kabila	tribo
kafas	kaĝo
kafe	kafo
kafe kan	kafejo
kai	malferma
kaici	komenci
kaka	fekaĵo
kal	nigra
kamar	ĉambro
kamar tal	planko
kamis	ĉemizo
kan	ejo
kanada	Kanadio
kanal	kanalo
kanun	leĝo
kap	preni
kar	fari (agi)
kara	litero
kari	curry
karo	kvadrato (karoo)
karot	karoto
karta	karto
kastan	kastano
kat	tondi (tranĉi)
kata	rakonto
kati	tranĉilo
kava	fosi
kawai	beleta
kazu	kazo
ke	kio?
kek	kuko
ken	povi
ketel	kaldrono
kia	demandi (ĉu)
kilo	mil (kilo-)
kilo gram	kilogramo
kimi	ĥemiaĵo
kimi logi	ĥemio
kira	luo
kira dar	luigi
kira kap	lui
kirat	karato
kismat	sorto (destino)
kitab	skribi
kitab kan	biblioteko
kitab macin	tajpilo
klar	klara
klas	klaso (kategorio)
klub	klubo
kolun	piliero (kolono)
komik	komika
kompani	firmao
komputer	komputilo
komun	komuna
kona	angulo
kong	truo
kontcung	insekto
konus	konuso
kop	taso (glaso)
kopi	kopio
kos	tuso
kosmos	spaco (universo)
kot	mantelo
koz	kaŭzo
kri	krii
kuan	larĝa
kul	mojosa
kultur	kulturo
kupa	kupola
kura	kuraci
kursi	seĝo
lab	lipo
lai	veni
lala	kuŝi
lampa	lampo
larva	larvo (raŭpo)
lastik	elasta
lasun	ajlo
latif	agrabla
lau	maljuna
leng	malvarma
leter	letero
letis	laktuko
liber	libera
lid	direkti
lig	ligi
lili	lilio
lim	kvin
limit	limo
lin	linio
lista	listo
lit	malgranda
liter	litro
lobak	rafano
loga	diri (vorti)
logi	scienco
lok	loko
long	longa
lulu	perlo
luna	luno
lusun	asparago
lut	rabi
macin	maŝino
madyar	Hungario
maf	pardonpeto
mafan	ĝeno
magi	sorĉo (magio)
magnet	magneto
mai	komerco
mai dar	vendi
mai kap	aĉeti
maidan	placo
mais	maizo
makala	artikolo
makan	butero
makas	tondilo
mama	patrino
man	viro
mana	signifi
mango	mango
manuc	homo
mar	fojo
mara	arbo
maraton	maratono
marce	promeni (marŝi)
marka	marko
marsi	Marso
mas	pli
mas ka bas	tro
masa	maso
masaj	masaĝo
masala	afero
masim	plej
mat	okulo
mat sui	larmo
matce	matĉo
matci	fiŝo
mater	materio
matras	matraco
mau	kato
mede	helpo
medi	meza
mega	miliono
megam	nubo
mei	ĉiu
mei ce	ĉio
mei jen	ĉiu homo
member	ano
meme	ŝafo
men	aro
mes	monato
mes 8 (mes bat)	aŭgusto
metal	metalo
metod	metodo
meza	tablo
mi	mi
mil	renkonti
milke	lakto
min	malpli
min ka bas	tro malmulte
minara	turo
ming	brila
minim	malplej
minus	krom
minut	minuto
misal	ekzemplo
misri	Egiptio
model	modeli
mol	mola
moral	moralo
mosim	sezono
moskit	moskito
mot	morto
motor	motoro
mucing	Jupitero
mucu	muso
muhim	grava
muka	vizaĝo
mum	vakso
mumu	bovo
mun	pordo
munkin	ebla
mur	muro
mus	devi
musik	muziko
muskul	muskolo
na	en (ĉe)
na cia	sub
na dur de	dum
na in	en
na par	sur
na wai	ekster
na wen	ĉirkaŭ
nabat	planto
nadi	rivero
nale	morgaŭ
nam	nomo
nama	viando
nami	ondo
nanas	ananaso
nas	popolo
nasia	ŝtato (nacio)
nau	cerebro
nederland	Nederlando
nen	jaro
nen festa	datreveno
neptun	Neptuno
neses	bezoni
net	reto
nic	niŝo
nipon	Japanio
no	ne
noi	naŭ
nong	farmi
nor	norda
normal	normalo
nos	nazo
not	rimarki
not buk	kajero
notce	nokto
nov	nova
nud	nuda (senvesta)
nul	nul
nul ce	nenio
nul jen	neniu
numer un	unua
nun	nun
o_	ho (oh)
oma	avino
opa	avo
or	orelo
paban	tabulo
pai	torto
pak	paki
paki	birdo
pal	frukto (rezulto)
pan	pano
panda	pando
pang	dika
panik	paniko
pantalon	pantalono
panyo	amiko
papa	patro
papagai	papago
papaya	papajo
paper	papero
par	suro
parda	kurteno
paus	paŭzi
peca	profesio (metiero)
ped	piedo
pei	pagi
pende	pendi
penguin	pingveno
penis	peniso
pensa	pensi
penta	pentri
perfet	perfekta
peri	feo
permis	permesi
pesa	mono
pifu	haŭto
piknik	pikniko
pingo	pomo
piper	pipro
piping	kritiki
pistol	pistolo
pitsa	pico
plan	plano
planet	planedo
plastik	plasto
plus	ankaŭ
pluto	Plutono
poli	multe (plure)
polis	polico
politik	politiko
polska	pollando
pont	indiki
por	por
porta	porti
posta	poŝto
pratik	praktika
presis	preciza (ekzakta, akurata)
proba	provi
problem	problemo
profesor	profesoro
program	programo
projet	projekto
pulo	insulo
punt	punkto
pupe	pupo
puru	plumo
putong	ĝenerala (universala)
radio	radio
rang	koloro
rapid	rapida
rasti	kreski
ratib	ordo
re	ree
re kar	ripeti
redi	preta
repor	raporti
restoran	restoracio
rezin	rezino
rik	riĉa
ris	rizo
robot	roboto
rol	rolo
rola	rolo
ron	plori
ros	ruĝa
rosia	Rusio
roza	rozo
ruk	dorso
ruski	rusa
sa	tiu (la)
sa djin	ĉi tiu
sa far	tiu
sabat	sabato
sabun	sapo
sabur	pacienta
sade	simpla
saf	pura
safar	vojaĝo
safar nik	turisto
sak	sako
sal	salo
salam	saluto
sam	tri (3)
sama	ĉielo
san	fari (produkti)
san kan	fabriko
sang	sango
sani	sledo
sant	sankta
sap	scii (koni)
sapat	ŝuo
sar	kapo
sar gut	kranio
se	si (mem)
seksi	seksumo
sekun	sekundo
sem	sama
sement	cemento
sens	senso
senti	senti (emocii)
seres	Cereso
serva	servi
set	sep
set var	semajno
sigaret	cigaredo
sin	signo
sir	sekreta
sirka	ĉirkaŭ
sis	ses
sistem	sistemo
siti	urbo
sofa	sofo
sofi	saĝa
sok	serĉi
sol	nur
son	dormo
soni	sono
sos	saŭco
sporte	sporto
stadion	stadiono
stop	halto
suan	acida
suba	mateno
suba den	antaŭtagmezo
suba yem	matenmanĝo
suci	suŝio
sud	sudo
sudafrika	Sudafriko
sui	akvo
suk	ŝati (feliĉa)
sukar	sukero
sultan	potenco
sun	baldaŭ
sundar	bela
suomi	Finnlando
sup	supo
surya	suno
suxa	seka
ta	"ĝi (li aŭ ŝi)
ri"
tabak	tabako
tabia	naturo
tabul	tabelo
tala	fermilo
tanax	Tanaĥo
tara	stelo
taza	freŝa
tca	teo
tca wan	teujo
tcap	premi (presi)
tcar	kvar
tcat	babili
tcat kamar	babilejo
tcatar	ombrelo
tcaya	ombro
tcile	Ĉilio
tcili	papriko
tcing	peti
tcip	Albanio
tcis	fromaĝo
tcoda	fiki
tcokolat	ĉokolado
tcuri	ŝteli
tekni	tekniko
tekni logi	teknologio
tela	tuko
tema	temo
ten	teni
tenta	tenti
tentci	vetero
teori	teorio
teste	testo
teyan	proponi
ti	vi
tik	prava
tim	teamo
ting	afero (aĵo)
tira	tiri
to	do
togo	Togolando
tong	barelo
tortuga	testudo
tot	tuta
tren	trajno
tsuka	vinagro
tualet	necesejo
tufan	ŝtormo
tul	ilo
tulip	tulipo
tunel tren	metroo
tuzi	kuniklo (leporo)
u_	aŭ
udas	malgaja
uma	ĉevalo
umur	aĝo
un	unu (1)
uni	unuigi
uni stat de amerika	Unuiĝintaj Ŝtatoj de Ameriko
uran	Urano
usa	Usono
vale	valo
var	tago de semajno
var 1 (var un)	lundo
var 2 (var du)	mardo
var 3 (var sam)	merkredo
var 4 (var tcar)	ĵaŭdo
var 5 (var lim)	vendredo
var 6 (var sis)	sabato
var 7 (var set)	dimanĉo
vat	aĵo
venus	Venuso
ver	vera
verme	vermo
vide	vidi (rigardi)
vin	vino
vinil	vinilo
virus	viruso
visin	najbaro
viza	montri
vizit	vizito
vodu	voduo
vokal	vokalo
vol	voli
volta	volto
vos	voĉo
wac	lavi
wad	promesi
waf	hundo
wai	ekstero
wai gok	eksterlando
wakil	reprezenti
wang	flava
wat	ŭato
wazir	ministro
wazir kan	ministerio
wen	cirklo
weste	okcidento
wiki	vikio
win	venko
wing	flugilo
xabar gazet	ĵurnalo
xali	malplena
xas	speciala
xatar	danĝero
xazin	trezoro
xen	malamo
xiyar	kukumo
xolera	ĥolero
xor	ĥoro
yad	memoro
yakin	certa
yala	hastigi
yang	stilo (maniero)
yani	tio estas (t.e.)
ye	jes
yehudi	judo
yep	folio
yer	hieraŭ
yo	iu
yo jen	iu homo
yo ting	io
yod	jodo
yoga	jogo
yoni	vagino
yosai	fortreso (fortiko)
yumor	humuro
yung	uzi
yungam	kuraĝa
yureka	trovi
zafran	safrano
zaitun	olivo
zalim	kruela
zaman	periodo
zambia	Zambio
zarura	necesa
ze	de (el)
zigzag	zigzago
zimbabwe	Zimbabvo
zina	adulto
zink	zinko
zira	kumino
zizi	muŝo
zon	zono
zukam	malvarmumo
zulu	zuluo
zumrud	smeraldo

